*************************
*.......................*
*.......................*
*.......................*
*.......................*
*.......................*
*.......................*
*.......................*
*.......................*
*.......................*
* ......................*
*.......................*
*.......................*
*.......................*
*.......................*
*.......................*
*.......................*
*.......................*
*.......................*
*.......................*
*.......................*
*.......................*
*.......................*
*.......................*
*.......................*
*************************
